**************************************************
*.....*...*...........*.....*...*.....*..........*
*.....*....***********...........................*
*.....*..........................................*
*.....*.......********...........................*
*...*.*...*.*.*...*.*...*.*.......*.*.*......*****
*.....*...............................*..........*
*.*...*.*.*.....*.*.*.*.*...*.*.*.....*.........**
*.*...****************...........................*
*.*.*.*...*.*.*...*.*.*...*...*.*.*.*.*..........*
*.....*..........................................*
*...*.*.*.......*.......*.....*...*...*..**..*****
*.....*..........................................*
*.....*.*.*.*.*...*.*...*.....*.......*....*******
*................................................*
*.*.....*.*.*.....*.........*.....*...****......**
*................................................*
*.....*...*.*.*.....*...*.*...*.*.*...*..........*
*.....................................*..........*
*..........*************..............*..........*
*.....................................*..........*
*.*.*.*.*...*...*.................*.*.*..........*
*.....................................*..........*
*.......*********.....................*..........*
*.....................................*..........*
*.....*.*.*.*...*.....*.......*.......*..........*
*.....................................*..........*
*.....................................*..........*
*****.................................*..........*
**************************************************
