**************************************************
*................................................*
**************************************************
*................................................*
*................................................*
**************************************************
*................................................*
*................................................*
*................................................*
**************************************************
*................................................*
*................................................*
*..............******************................*
*..............*................*................*
*..............*................*................*
*..............*................*................*
*..............*................*................*
*..............******************................*
*................................................*
*................................................*
*................................................*
*....***********.................................*
**************************************************
*................................................*
*................................................*
**************************************************
*................................................*
*................................................*
*................................................*
**************************************************