**************************************************
*................................................*
*................................................*
*................................................*
*................................................*
*................................................*
*................................................*
*................................................*
*................................................*
*................................................*
*................................................*
*................................................*
*................................................*
*................................................*
*................................................*
*................................................*
*................................................*
*................................................*
*................................................*
*................................................*
*................................................*
*................................................*
*................................................*
*................................................*
*................................................*
*................................................*
*................................................*
*................................................*
*................................................*
**************************************************