**************************************************
......*...*...........*.....*...*.....*..........*
***.***.*.*.*********.*.*.*.*.*.*.***.*.....****.*
*.....*.*.*.....*.*...*.*.*.*.*.*.*...*..........*
*.*******.***.***.*.*******.*.***.*.******.......*
*...*.....*.*.*...*.*...*.*.......*.*.*......*****
*.***.*.*.*.*.*.***.*.*.*.*.*.*.***.*.*..........*
*.*...*.*.*.....*.*.*.*.*...*.*.*.....*.........**
*.*****.*****.*.*.*****.***.***.*.***.*....*******
*.*.*.....*.*.*...*.*.*...*...*.*.*.*.*..........*
*.*.*.***.*.***.*.*.*.*.*****.*****.*.*.....******
*...*.*.*.......*.......*.....*...*...*..**..*****
***.*.*.*.*.*.*.***********.*****.*.***..........*
*.....*.*.*.*.*...*.*...*.....*.......*....*******
*.*****.***.*****.*.***.*********.*****..........*
*.*.....*.*.*.....*.........*.....*...****......**
*.*.*****.*.*.*********.*.*.*****.*.******.......*
*.....*...*.*.*.....*...*.*...*.*.*...*..........*
*.*.*****.***.*.***.*********.*.*.*.*****......***
*.*...*...*.......*.*.......*.*.*.*...*......*****
*.***.*.*****.***.*********.*.*.*.*.*.**.*.*..****
*.*.*.*.*...*...*.................*.*.*..........*
*.*.***.*.*.*.*******.***.***.*.***.*.*.*.*.*.*.**
*.*...*...*.......*.*.*.....*.*.*.*.*.*.*.*.*.*.**
*.***.*.*.*.***.*.*.*******.***.*.***.*..........*
*.....*.*.*.*...*.....*.......*.......*..........*
*.....................................*..........*
*......****.........********..........******.....*
*****................*****************************
**************************************************
